########$#############*
########@#############*
########@#############*
#@@@@@@@@@@@@@@@@@@@@#*
########@#############*
########@#############*
########@#############*
########@#############*